1 1 1 1 1 1 1 1 1 1 1 1 1 1 1 1 1
1 10 5 5 5 5 5 5 5 5 5 5 5 9 1 10 5
1 8 4 0 4 3 4 0 4 0 4 2 4 7 1 8 0
1 8 0 2 0 0 0 0 0 0 0 0 3 7 1 8 0
1 8 4 0 4 0 4 0 4 0 4 0 4 7 1 8 0
1 8 0 2 0 3 0 0 0 0 0 3 0 7 1 8 0
1 8 4 0 4 0 4 0 4 0 4 0 4 7 1 8 0
1 8 2 0 0 0 3 0 0 0 0 0 0 7 1 8 0
1 8 4 0 4 0 4 0 4 0 4 0 4 7 1 8 0
1 8 0 0 0 0 0 0 0 0 0 0 2 7 1 8 0
1 8 4 0 4 0 4 0 4 0 4 0 4 7 1 8 0
1 8 0 0 2 0 0 0 0 0 0 3 0 7 1 8 0
1 8 4 0 4 0 4 0 4 0 4 0 4 7 1 8 0
1 8 0 0 0 3 0 0 2 0 0 0 0 7 1 8 0
1 12 6 6 6 6 6 6 6 6 6 6 6 11 1 12 6
1 1 1 1 1 1 1 1 1 1 1 1 1 1 1 1 1