1 1 1 1 1 1 1 1 1 1 1 1 1 1 1 1 1
1 10 5 5 5 5 5 5 5 5 5 5 5 9 1 10 5
1 8 14 0 14 3 14 0 14 0 14 2 14 7 1 8 0
1 8 0 2 0 0 0 0 0 0 0 0 3 7 1 8 0
1 8 14 0 14 0 14 0 14 0 14 0 14 7 1 8 0
1 8 0 2 0 3 0 0 0 0 0 3 0 7 1 8 0
1 8 14 0 14 0 14 0 14 0 14 0 14 7 1 8 0
1 8 2 0 0 0 3 0 0 0 0 0 0 7 1 8 0
1 8 14 0 14 0 14 0 14 0 14 0 14 7 1 8 0
1 8 0 0 0 0 0 0 0 0 0 0 2 7 1 8 0
1 8 14 0 14 0 14 0 14 0 14 0 14 7 1 8 0
1 8 0 0 2 0 0 0 0 0 0 3 0 7 1 8 0
1 8 14 0 14 0 14 0 14 0 14 0 14 7 1 8 0
1 8 0 0 0 3 0 0 2 0 0 0 0 7 1 8 0
1 12 6 6 6 6 6 6 6 6 6 6 6 11 1 12 6
1 1 1 1 1 1 1 1 1 1 1 1 1 1 1 1 1