1 1 1 1 1 1 1 1 1 1 1 1 1 1 1 1 1
1 10 5 5 18 5 5 5 15 5 5 5 5 9 1 10 5
1 8 4 0 4 3 4 0 4 0 4 2 4 16 1 8 0
1 8 0 2 0 0 0 14 0 0 0 14 3 7 1 8 0
1 17 4 0 4 0 4 0 4 0 4 0 4 7 1 8 0
1 8 0 2 0 2 0 0 0 0 0 3 0 7 1 8 0
1 17 4 0 4 0 4 0 4 0 1 13 4 19 1 8 0
1 20 2 0 13 0 3 0 0 3 0 0 0 7 1 8 0
1 8 4 0 4 0 5 0 4 0 4 0 4 7 1 8 0
1 8 0 0 0 0 0 0 0 0 0 0 2 16 1 8 0
1 20 4 0 4 0 4 14 0 0 4 0 4 7 1 8 0
1 8 0 0 2 3 0 0 0 0 13 3 0 7 1 8 0
1 8 4 0 4 0 4 0 4 0 4 0 4 16 1 8 0
1 8 0 0 0 3 0 0 2 0 0 14 0 7 1 8 0
1 12 6 6 6 6 6 6 6 6 6 6 6 11 1 12 6
1 1 1 1 1 1 1 1 1 1 1 1 1 1 1 1 1